13 3 3 3 3 3 3 3 3 3 3 3 3 12 13 3 3 3 3 3 3 3 3 3 3 12 13 3 3 3 3 3 3 3 3 3 3 12 13 3 3 3 3 3 3 3 3 3 3 3 3 12
4 1 1 1 1 1 1 1 1 1 1 1 1 5 4 1 1 1 1 1 1 1 1 1 1 5 4 1 1 1 1 1 1 1 1 1 1 5 4 1 1 1 1 1 1 1 1 1 1 1 1 5 
4 1 6 2 2 7 1 6 2 2 2 7 1 5 4 1 6 2 2 2 2 2 2 7 1 5 4 1 6 2 2 2 2 2 2 7 1 5 4 1 6 2 2 2 7 1 6 2 2 7 1 5 
4 9 5 8 8 4 1 5 8 8 8 4 1 5 4 1 5 8 8 8 8 8 8 4 1 5 4 1 5 8 8 8 8 8 8 4 1 5 4 1 5 8 8 8 4 1 5 8 8 4 9 5
4 1 10 3 3 11 1 10 3 3 3 11 1 10 11 1 10 3 3 3 3 3 3 11 1 10 11 1 10 3 3 3 3 3 3 11 1 10 11 1 10 3 3 3 11 1 10 3 3 11 1 5
4 1 1 1 1 1 1 1 1 1 1 1 1 1 1 1 1 1 1 1 1 1 1 1 1 1 1 1 1 1 1 1 1 1 1 1 1 1 1 1 1 1 1 1 1 1 1 1 1 1 1 5 
4 1 6 2 2 7 1 6 7 1 6 2 2 2 2 2 2 7 1 6 7 1 6 2 2 2 2 2 2 7 1 6 7 1 6 2 2 2 2 2 2 7 1 6 7 1 6 2 2 7 1 5 
4 1 10 3 3 11 1 5 4 1 10 3 3 12 13 3 3 11 1 5 4 1 10 3 3 12 13 3 3 11 1 5 4 1 10 3 3 12 13 3 3 11 1 5 4 1 10 3 3 11 1 5
4 1 1 1 1 1 1 5 4 1 1 1 1 5 4 1 1 1 1 5 4 1 1 1 1 5 4 1 1 1 1 5 4 1 1 1 1 5 4 1 1 1 1 5 4 1 1 1 1 1 1 5 
15 2 2 2 2 7 1 5 4 1 6 7 1 5 4 1 6 2 2 14 15 2 2 7 1 5 4 1 6 2 2 14 15 2 2 7 1 5 4 1 6 7 1 5 4 1 6 2 2 2 2 14
8 8 8 8 8 4 1 5 4 1 5 4 1 10 11 1 10 3 3 12 13 3 3 11 1 10 11 1 10 3 3 12 13 3 3 11 1 10 11 1 5 4 1 5 4 1 5 8 8 8 8 8
8 8 8 8 8 4 1 5 4 1 5 4 1 1 1 1 1 1 1 5 4 1 1 1 1 1 1 1 1 1 1 5 4 1 1 1 1 1 1 1 5 4 1 5 4 1 5 8 8 8 8 8
8 8 8 8 8 4 1 5 4 1 5 4 1 6 2 2 2 7 1 5 4 1 17 18 19 20 20 21 22 23 1 5 4 1 6 2 2 2 7 1 5 4 1 5 4 1 5 8 8 8 8 8
3 3 3 3 3 11 1 10 11 1 10 11 1 5 13 3 3 11 1 10 11 1 37 16 16 16 16 16 16 24 1 10 11 1 10 3 3 12 4 1 10 11 1 10 11 1 10 3 3 3 3 3
16 16 16 16 16 16 1 1 1 1 1 1 1 5 4 1 1 1 1 1 1 1 36 16 16 16 16 16 16 25 1 1 1 1 1 1 1 5 4 1 1 1 1 1 1 1 16 16 16 16 16 16
2 2 2 2 2 7 1 6 7 1 6 2 2 14 4 1 6 2 2 2 7 1 35 16 16 16 16 16 16 26 1 6 2 2 2 7 1 5 15 2 2 7 1 6 7 1 6 2 2 2 2 2
8 8 8 8 8 4 1 5 4 1 10 3 3 3 11 1 10 3 3 12 4 1 34 33 32 31 30 29 28 27 1 5 13 3 3 11 1 10 3 3 3 11 1 5 4 1 5 8 8 8 8 8
8 8 8 8 8 4 1 5 4 1 1 1 1 1 1 1 1 1 1 5 4 1 1 1 1 1 1 1 1 1 1 5 4 1 1 1 1 1 1 1 1 1 1 5 4 1 5 8 8 8 8 8
8 8 8 8 8 4 1 5 4 1 6 2 2 2 2 2 2 7 1 5 4 1 6 2 2 2 2 2 2 7 1 5 4 1 6 2 2 2 2 2 2 7 1 5 4 1 5 8 8 8 8 8
13 3 3 3 3 11 1 10 11 1 10 3 3 12 13 3 3 11 1 10 11 1 10 3 3 12 13 3 3 11 1 10 11 1 10 3 3 12 13 3 3 11 1 10 11 1 10 3 3 3 3 12
4 1 1 1 1 1 1 1 1 1 1 1 1 5 4 1 1 1 1 1 1 1 1 1 1 5 4 1 1 1 1 1 1 1 1 1 1 5 4 1 1 1 1 1 1 1 1 1 1 1 1 5 
4 1 6 2 2 7 1 6 2 2 2 7 1 5 4 1 6 2 2 2 2 2 2 7 1 5 4 1 6 2 2 2 2 2 2 7 1 5 4 1 6 2 2 2 7 1 6 2 2 7 1 5 
4 1 10 3 12 4 1 10 3 3 3 11 1 10 11 1 10 3 3 3 3 3 3 11 1 10 11 1 10 3 3 3 3 3 3 11 1 10 11 1 10 3 3 3 11 1 5 13 3 11 1 5
4 9 1 1 5 4 1 1 1 1 1 1 1 1 1 1 1 1 1 1 1 1 1 1 1 1 1 1 1 1 1 1 1 1 1 1 1 1 1 1 1 1 1 1 1 1 5 4 1 1 9 5
15 2 7 1 5 4 1 6 7 1 6 2 2 2 2 2 2 7 1 6 7 1 6 2 2 2 2 2 2 7 1 6 7 1 6 2 2 2 2 2 2 7 1 6 7 1 5 4 1 6 2 14
13 3 11 1 10 11 1 5 4 1 10 3 3 12 13 3 3 11 1 5 4 1 10 3 3 12 13 3 3 11 1 5 4 1 10 3 3 12 13 3 3 11 1 5 4 1 10 11 1 10 3 12
4 1 1 1 1 1 1 5 4 1 1 1 1 5 4 1 1 1 1 5 4 1 1 1 1 5 4 1 1 1 1 5 4 1 1 1 1 5 4 1 1 1 1 5 4 1 1 1 1 1 1 5 
4 1 6 2 2 2 2 14 15 2 2 7 1 5 4 1 6 2 2 14 15 2 2 7 1 5 4 1 6 2 2 14 15 2 2 7 1 5 4 1 6 2 2 14 15 2 2 2 2 7 1 5
4 1 10 3 3 3 3 3 3 3 3 11 1 10 11 1 10 3 3 3 3 3 3 11 1 10 11 1 10 3 3 3 3 3 3 11 1 10 11 1 10 3 3 3 3 3 3 3 3 11 1 5
4 1 1 1 1 1 1 1 1 1 1 1 1 1 1 1 1 1 1 1 1 1 1 1 1 1 1 1 1 1 1 1 1 1 1 1 1 1 1 1 1 1 1 1 1 1 1 1 1 1 1 5 
15 2 2 2 2 2 2 2 2 2 2 2 2 2 2 2 2 2 2 2 2 2 2 2 2 2 2 2 2 2 2 2 2 2 2 2 2 2 2 2 2 2 2 2 2 2 2 2 2 2 2 14